#########  ###############  #########
#.......#                #             #
#.......#                #             #
#########                #########
                          #####

                          #####
#########                #########
#.......#                #             #
#.......#                #             #
#########  ###############  #########
