#################  ############  ###################
#...............#               #                 #
#...............#               #   ############  #
#...............#               #   #.......#...#  #
#...............#############   #   #.......#...#  #
#.........................#   #   #.......#...#  #
#.........................#   #   #.......#...#  #
#.........................#   #   #.......#...#  #
#.........................#   #   #.......#...#  #
######################   #   #   #.......#...#  #
                     #   #   #   #.......#...#  #
                     #   #   #   #.......#...#  #
                     #   #   #   #.......#...#  #
                     #   #   #   #.......#...#  #
                     #   #   #   #.......#...#  #
                     #   #   #   ############  #
                     #   #                    #
                     ##########################
