#################################  ###############################  #################################
#..............#                                              #                                              #
#..............#                                              |                                              #
#..............#                                              |                                              #
#..............#                                              |                                              #
#..............#                                              |                                              #
#..............##############################################                                              #
#..............                      ############################                                              #
#..............                      #                     ...#                                              #
#.###########.                      #                     ...#                                              #
#.###########.                      #                     ...#                                              #
#.###########.                      #                     ...#                                              #
#..............                      #                     ...#                                              #
#..............                      #                     ...#                                              #
#.###########.                      #                     ...#                                              #
#.###########.                      #                     ...#                                              #
#.###########.######################                     ...#################                             #
#......................|                                     |                     #                             #
#......................|                                     |                     #                             #
#################################                     ...#################################                     #
                          #                     ...#                                                              #
                          #                     ...#                                                              #
                          #                     ...#                                                              #
                          #                     ...#                                                              #
                          #                     ...#                                                              #
                          #                     ...#                                                              #
                          #                     ...#                                                              #
                          #########################                                                              #
