r1,,,,,,,,
1,1,1,1,1,1,1,1,1
1,,,,,,,,1
1,,p,,b,,b,,1
1,,,,t,,,,1
1,,b,t,tp,t,b,,1
1,,,,t,,,,1
1,,b,,b,,r2,,1
1,,,,,,,,1
1,1,1,1,1,1,1,1,1
,,,,,,,,
,,,,,,,,
r2,,,,,,,,
1,1,1,,,,,,
1,0,0,,,,,,
1,0,1,,,,,,
