r1,,,,,,,,
1,1,1,1,1,1,1,1,1
1,,,,,,1,1,1
1,,0;r2,,b,,1,1,1
1,,,,,,1,1,1
1,1,1,p,1,1,1,1,1
1,1,1,,,,tp,1,1
1,,,,,,t,1,1
1,1,1,,,,,1,1
1,1,1,1,1,1,1,1,1
,,,,,,,,
,,,,,,,,
,,,,,,,,
r2,,,,,,,,
1,1,1,1,1,,,,
1,,,,1,,,,
1,,,,0,,,,
1,,,,1,,,,
1,1,1,1,1,,,,
,,,,,,,,
