r1,,,,,,,,
1,1,1,1,0,1,1,1,1
1,,,,,1,1,1,1
1,,1,1,1,1,0,1,1
1,,,,,,,,1
1,,,,,,,,1
1,1,1,,1,1,1,1,1
1,tp,,r1,1,,,1,1
1,t,,,p,,,1,1
1,1,1,1,1,1,1,1,1
